
sudo pacman -S gedit gnome-terminal pulseaudio pulseaudio-alsa pavucontrol firefox vlc eog eog-plugins chromium unzip unrar p7zip pidgin toxcore deluge smplayer audacious qmmp gimp xfburn thunderbird gnome-system-monitor doublecmd-gtk2 gnome-calculator pinta recoll deadbeef veracrypt bleachbit gnome-screenshot evince mlocate antiword catdoc unrtf djvulibre id3lib mutagen python2-pychm aspell-en git calibre ttf-freefont ttf-linux-libertine ntfs-3g libmtp




## sed -i 's/^#Server/Server/' /etc/pacman.d/mirrorlist.backup



https://www.archlinux.org/mirrorlist/?country=RU&protocol=http&protocol=https&ip_version=4&ip_version=6

Australia - AU
Austria - AT
Bangladesh - BD
Belarus - BY
Belgium - BE
Bosnia and Herzegovina - BA
Brazil - BR
Bulgaria - BG
Canada - CA
Chile - CL
China - CN
Colombia - CO
Croatia - HR
Czechia - CZ
Denmark - DK
Ecuador - EC
Finland - FI
France - FR
Georgia - GE
Germany - DE
Greece - GR
Hong Kong - HK
Hungary - HU
Iceland - IS
India - IN
Indonesia - ID
Iran - IR
Ireland - IE
Israel - IL
Italy - IT
Japan - JP
Kazakhstan - KZ
Kenya - KE
Latvia - LV
Lithuania - LT
Luxembourg - LU
Macedonia - MK
Mexico - MX
Netherlands - NL
New Caledonia - NC
New Zealand - NZ
Norway - NO
Paraguay - PY
Philippines - PH
Poland - PL
Portugal - PT
Qatar - QA
Romania - RO
Russia - RU
Serbia - RS
Singapore - SG
Slovakia - SK
Slovenia - SI
South Africa - ZA
South Korea - KR
Spain - ES
Sweden - SE
Switzerland - CH
Taiwan - TW
Thailand - TH
Turkey - TR
Ukraine - UA
United Kingdom - GB
United States - US
Vietnam - VN







